1,1,1,1,1,1,1,1,1,1,1,1,1,1,1
1,0,1,0,0,0,1,0,0,0,0,0,1,0,1
1,0,1,0,1,0,1,1,1,1,1,0,1,0,1
1,0,0,0,1,0,0,0,0,1,0,0,1,0,1
1,0,1,1,1,1,0,0,0,1,0,1,1,0,1
1,0,0,0,0,1,1,1,0,1,0,0,0,0,1
1,1,1,0,1,1,0,0,0,1,0,1,1,0,1
1,0,0,0,0,0,0,0,0,0,0,1,0,0,1
1,1,0,1,0,1,0,0,0,1,0,0,0,1,1
1,0,0,1,0,1,1,0,1,1,0,1,0,0,1
1,0,1,1,0,0,1,0,1,0,0,0,1,1,1
1,0,1,0,1,1,1,0,1,0,1,0,0,0,1
1,0,1,0,1,0,0,0,1,0,1,1,1,0,1
1,0,0,0,1,0,1,0,0,0,0,0,0,0,1
1,1,1,1,1,1,1,1,1,1,1,1,1,1,1

a,1,1,u
a,4,1,u

e,1,1

k,14,7
k,7,7
k,1,13
k,1,5

x,14,14
