1,1,1,1,1,1,1,1,1,1,1,1,1,1,1
1,0,1,0,0,0,1,0,0,0,0,0,1,0,1
1,0,1,0,1,0,1,1,1,1,1,0,1,0,1
1,0,0,0,1,0,0,0,0,1,0,0,1,0,1
1,0,1,1,1,1,0,0,0,1,0,1,1,0,1
1,0,0,0,0,1,1,1,0,1,0,0,0,0,1
1,1,1,0,1,1,0,0,0,1,0,1,1,0,1
1,0,0,0,0,0,0,0,0,0,0,1,0,0,1
1,1,0,1,0,1,0,0,0,1,0,0,0,1,1
1,0,0,1,0,1,1,0,1,1,0,1,0,0,1
1,0,1,1,0,0,1,0,1,0,0,0,1,1,1
1,0,1,0,1,1,1,0,1,0,1,0,0,0,1
1,0,1,0,1,0,0,0,1,0,1,1,1,0,1
1,0,0,0,1,0,1,0,0,0,0,0,0,0,1
1,1,1,1,1,1,1,1,1,1,1,1,1,1,1

a,1,1,u
a,1,4,d
a,1,7,l
a,3,13,r
a,4,7,d
a,5,4,r
a,5,10,l
a,7,1,l
a,9,10,r
a,10,1,r
a,11,7,l
a,11,12,d
a,13,11,d

e,1,1

k,9,13
k,1,7
k,10,5

x,3,7,u
